..........................................#########......
..........................................#.......#......
..........................................#.......#......
..........................................#.......#......
..........................................#.......#......
..........................................#.......#......
..........................................#.......#......
..........................................#.......#......
......................................#############......
......................................#...#..............
......#.............................^######..............
......#...............................#..................
......#...............................#..................
......#...............................#..................
......#...............................#..................
......#...............................#..................
......#...............................#########..........
......#.......................................#..........
#######.................................#########........
#.......................................#.....#.#........
#.......................................#.....#.#........
#.......................................#.....#.#........
#.......................................#.....###########
#.......................................#.......#.......#
###########.............................#.......#.......#
..........#.............................#.......#.......#
..........#.............................###########.....#
..........#.....................................#.#.....#
..........#.....................................#.#.....#
..........#.....................................#.#.....#
..........#.....................................#########
..........#.......................................#......
..........###########.......................#######......
....................#.......................#............
....................#.............#########.#............
....................#.............#.......#.#............
....................#.............#.......#.#............
....................#.............#.......#.#............
....................#########.....#.......#.#............
............................#.....#.......#.#............
............................#.....#...#######............
............................#.....#...#...#..............
............................#.#############..............
............................#.#...#...#..................
............................#######...#..................
..............................#.......#..................
..............................#.......#..................
..............................#.......#..................
..............................#.......#..................
..............................#.......#..................
..............................#########..................